11111111111111111111
                   1
111111111111111111 1
              2  1 1
1      1      4    1
1            11111 1
1    111111111     1
1   1111111111 11111
1  11111111111 11111
1 111111111111     1
1            11111 1
11111111111  1     1
11111111111  1 11111
11111111111  1 11111
11111111111  1     1
11111111111  11111 1
11111111111  1     1
11111111111  1 11111
11111111111  1 11111
11111111111  1     1
11111111111 11111  1
11111111111 11111  1
11111111111 11111  1
11111111111 11111  1
11111       11111  1
11111 11111111111  1
11111              1
11111311111111111111
