11111111
1 1    1
1    1 1
1    1 1
1      1
1    111
11     1
11111111
