111111111
1      11
    1 1 1
1   1 1 1
1   1 1 1
1   1 1 1
1   1   1
111111111
