111111111
1      11
    1 1 1
1   1 1 1
1 23 1  1
1   1 1 1
11  11111
13  11111
11  11111
11  11111
11  11111
11  11111
11  11111
