1111111111111111111111111111111111111111111111111111111111111111111111111111111111111111111111111111111111111111111111111111111111111111111111111
1           1111111111111111111111111111111111111111111111111111111111111111111111111111111111111111111111111111111111111111111111111111111111111
1              1111111111111111111111111111111111111111111111111111111111111111111111111111111111111111111111111111111111111111111111111111111111
1                111111111111111111111111111111111111111111111111111111111111111111111111111111111111111111111111       1111111111111111111111111
1                   11111111111111111111111111111111111111111111111111111111111111111111111111111111111111111               111111111111111111111
1                      111111111111111111111111111111111111111111111111111111111111111111111111111111111       111111111    111111111111111111111
1               4           1111111111111111111111111111111111111111111111111111111111111111111111111      111111111111111    1111111111111111111
11          111111                 11111111111111111111111111111111111111111111111111111111111111111     111111111111111111     11111111111111111
11         111111111                11111111111111111111111111111111111111111111111111111111111111    111111111111111111111     11111111111111111
111        1111111111               11111111111111111111111111111111111111111111111111111111111111   1111111111111111111111     11111111111111111
1111       11111111111111               111111111111111111111111111111111111111111111111111111111   1111111111111111111111     111111111111111111
11111       11111111111111                     1111111111111111111111111111111111111111111111111    111111111111111111111     1111111111111111111
111111       1111111111111111111                    1111111111111111111111111111111111111111111    11111111111111111111     111111111111111111111
1111111       111111111111111111111111111111111111      111111111111111111111111111111111111111    111111111111111111     11111111111111111111111
11111111      1111111111111111111111111111111111111111      11111111111111111111111111111111111    1111111111111       11111111111111111111111111
111111111      1111111111111111111111111111111111111111111       11111111111111111111111111111111    11111111       11111111111111111111111111111
111111111      111111111111111111111111111111111111111111111111       1111111111111111111111111111      11        1111111111111111111111111111111
111111111      11111111111111111111111111111111111111111111111111111        1111111111111111111111112   1   1111111111111111111111111111111111111
111111111      11111111111111111111111111111111111111111111111111111        11111111111111111111111111        11111111111111111111111111111111111
1111111111      1111111111111111111111111111111111111111111111111111111111       1111111111111111111     1      111111111111111111111111111111111
1111111111      111111111111111111111111111111111111111111111111111111111111111                        111111     1111111111111111111111111111111
1111111111      111111111111111111111111111111111111111111111111111111111111111111111               11111111111         1111111111111111111111111
1111111111      111111111111111111111111111111111111111111111111111111111111111111111111111111111111111111111111111       11111111111111111111111
11111111111      11111111111111111111111111111111111111111111111111111111111111111111111             1111111111111111111    111111111111111111111
11111111111      111111111111111111111111111111111111111111111111111111111111111111                     111111111111111111     111111111111111111
11111111111      1111111111111111111111111111111111111111111111111111111111111111     111111111111        111111111111111111    11111111111111111
11111111111      11111111111111111111111111111111111111111111111111111111111111     111111111111111         11111111111111111   11111111111111111
11111111111       11111111111111111111111111111111111111111111111111111111111      1111111111111111111      111111111111111111   1111111111111111
11111111111       111111111111111111111111111111111111111111111111111111111      11111111111111111111111     11111111111111111   1111111111111111
11111111111       111111111111111111111111111111111111111111111111111111      111111111111111111111111111     11111111111111111   111111111111111
111111111111       111111111111111111111111111111111111111111111111111       11111111111111111111111111111     11111111111111111   11111111111111
1111111111111       1111111111111111111111111111111111111111111111111      1111111111111111111111111111111     111111111111111111  11111111111111
111111111111111      11111111111111111111111111111111111111111111111     1111111111111111111111111111111111     1111111111111111    1111111111111
111111111111111       111111111111111111111111111111111111111111111     11111111111111111111111111111111111     1111111111111111    1111111111111
1111111111111111       11111111111111111111111111111111111111111111     111111111111111111111111111111111111    1111111111111111    1111111111111
11111111111111111       111111111111111111111111111111111111111111     111111111111111111111111111111111111     111111111111111     1111111111111
111111111111111111       111111111111111111111111111111111111111111     11111111111111111111111111111111111      11111111111111     1111111111111
1111111111111111111       11111111111111111111111111111111111111111        111111111111111111111111111111111     11111111111111     1111111111111
11111111111111111111       1111111111111111111111111111111111111111111        111111111111111111111111111111     11111111111111    11111111111111
11111111111111111111111     111111111111111111111111111111111111111111111       1111111111111111111111111111    11111111111111   1111111111111111
111111111111111111111111       11111111111111111111111111111111111111111111        111111111111111111111111     11111111111111   1111111111111111
111111111111111111111111         1111111111111111111111111111111111111111111         111111111111111111111     111111111111111   1111111111111111
1111111111111111111111111         1111111111111111111111111111111111111111111        111111111111111111111    11111111111111111   111111111111111
11111111111111111111111111111       111111111111111111111111111111111111111111       1111111111111111111     11111111111111111    111111111111111
1111111111111111111111111111111      1111111111111111111111111111111111111111        111111111111111111     111111111111111111   1111111111111111
1111111111111111111111111111111111     1111111111111111111111111111111111111        1111111111111111      1111111111111111111   11111111111111111
111111111111111111111111111111111111     11111111111111111111111111111111111        111111111111111      1111111111111111111   111111111111111111
1111111111111111111111111111111111111        111111111111111111111111111111        111111111111111     111111111111111111111   111111111111111111
11111111111111111111111111111111111111        111111111111111111111111111          11111111111111     111111111111111111111   1111111111111111111
11111111111111111111111111111111111111111       11111111111111111111              11111111111111     111111111111111111111   11111111111111111111
11111111111111111111111111111111111111111111          111111111111              111111111111111    11111111111111111111111   11111111111111111111
1111111111111111111111111111111111111111111111111                               111111111111111     1111111111111111111111   11111111111111111111
11111111111111111111111111111111111111111111111111111             11111111111111111111111111      11111111111111111111111    11111111111111111111
1111111111111111111111111111111111111111111111111111111111111111111111111111111      111111    11111111111111111111111111   111111111111111111111
111111111111111111111111111111111111111111111111111111111111111111111111              1111   111111111111111111111111111   1111111111111111111111
111111111111111111111111111111111111111111111111111111111111111111111           1           111111111111111111111111111    1111111111111111111111
11111111111111111111111111111111111111111111111111111111111111111111         11111111113        11111111111111111111111    1111111111111111111111
111111111111111111111111111111111111111111111111111111111111111111111      111111111111    1       111111111111111111111   1111111111111111111111
111111111111111111111111111111111111111111111111111111111111111111111       111111111     11       1111111111111111111    11111111111111111111111
11111111111111111111111111111111111111111111111111111111111111111111111        11111     11111       1111111111111111     11111111111111111111111
1111111111111111111111111111111111111111111111111111111111111111111111111               11111111       1111111111        111111111111111111111111
11111111111111111111111111111111111111111111111111111111111111111111111111111111  11111111111111111        111         11111111111111111111111111
111111111111111111111111111111111111111111111111111111111111111111111111111111111111111111111111111111111            1111111111111111111111111111
1111111111111111111111111111111111111111111111111111111111111111111111111111111111111111111111111111111111111111111111111111111111111111111111111
1111111111111111111111111111111111111111111111111111111111111111111111111111111111111111111111111111111111111111111111111111111111111111111111111
